bbbbbbbbbbbbbbbb
b00000000000000b
b00000000000000b
b00000000000000b
b0000000p000000b
b0et000000t0000b
b0000000T000000b
b00000000000000b
bbbbbbbbbbbbbbbb
