TTTTTbbbbbbbbbebbbbbbbbbbTTTTT
T0000000000000000000000000000T
T0000000000000000000000000000T
T0000000000000000000000000000T
T0000000000000000000000000000T
T0000000000000000000000000000T
T0000000000000000000000000000T
T0000000000000k00000000000000T
T0000000000000000000000000000T
T0000000000000000000000000000T
T0000000000000000000000000000T
T0000000000000000000000000000T
T0000000000000000000000000000T
T0000000000000000000000000000T
T0000000000000000000000000000T
T0000000000000000000000000000T
T0000000000000000000000000000T
T0000t00000000b000000000p0000T
T0000000000000000000000000000T
TTTTTTTTTTTTTTTTTTTTTTTTTTTTTT

!AddText=15,3,Look at this the finale level, not so hard, huh?
!AddText=15,5,well it doesn't matter at this point 
!AddText=15,6,atleast did you like the game?
!AddText=15,7,worked hard on this one
!AddText=15,8,cat_or_not
!AddText=15,9,<3
!maxMoves=60
