bbbbbbbbbbbbbbbbbbbbbbbbbbbbbb
b0000000000000b00000000000000b
b000t000000000000000000p00000b
b0000000000000000000000000000b
b000bbTb00bbTbbbbTb00bbTb0000b
b000000000000bbb0000000000000b
b0000000000000b00000000000000b
b000000k000000000000000000000e
b0000000000000000000000000000b
b000bbTb00bbTbbbbTb00bbTb0000b
b000000000000bbb0000000000000b
b0000000000000000000000000000b
bbbbbbbbbbbbb000bbbbbbbbbbbbbb
b0000000000000000000000000000b
b0000000000000000000000000000b
b0000000000000000000000000000b
b0000000000000000000000000000b
b0000000000000000000000000000b
b0000000000000000000000000000b
bbbbbbbbbbbbbbbbbbbbbbbbbbbbbb