bbbbbbbbbbbbbbbbbbbbbbbbbbbbbb
b0000000000000b00000000000000b
b000t000000000000000000p00000b
b0000000000000000000000000000b
b000bTTTT0TTTTbTTTT0TTTTb0000b
b000000000000bbb0000000000000b
b0000000000000b00000000000000b
b000000k000000000000000000000e
b0000000000000000000000000000b
b000bTTTT0TTTTbTTTT0TTTTb0000b
b000000000000bbb0000000000000b
b0000000000000000000000000000b
bbbbbbbbbbbbbbbbbbbbbbbbbbbbbb
000000000000000000000000000000
000000000000000000000000000000
000000000000000000000000000000
000000000000000000000000000000
000000000000000000000000000000
000000000000000000000000000000
000000000000000000000000000000
